0 0 0 0 0 0 0 0 0 0 0 0 0 0 0 0 0 0 0 0
0 -48 -78 -75 -65 -34 -48 -58 -15 -57 -4 -42 -26 -11 -91 -67 -14 -58 -88 0
0 -98 -54 -33 -35 -8 -24 -43 -92 -85 -48 -45 -9 -23 -83 -8 -55 -33 -31 0
0 -81 -79 -40 -40 -13 -34 -60 -73 -75 -54 -66 -6 -35 -77 -53 -32 -48 -40 0
0 -41 -65 -33 -34 -80 -63 -47 -81 -31 -59 -53 -20 -30 -20 -17 -32 -43 -47 0
0 -31 -86 -46 -36 -70 -39 -41 -58 -29 -8 -90 -37 -32 -18 -49 -69 -12 -69 0
0 -12 -80 -98 -66 -76 -21 -39 -69 -32 -99 -53 -23 -73 -61 -93 -43 -13 -93 0
0 -38 -41 -84 -55 -35 -50 -95 -55 -43 -18 -57 -2 -54 -21 -85 -1 -84 -28 0
0 -89 -74 -86 -2 -33 -56 -85 -26 -17 0 -89 -50 -18 -69 -77 -75 -70 -57 0
0 -63 -62 -5 -29 -32 -76 -96 -54 -71 -98 -56 -72 -44 -5 -77 -11 -57 -39 0
0 -18 -49 -61 -53 -62 -45 -60 -20 -78 -31 -65 -20 -16 -83 0 0 -23 -52 0
0 -44 -92 -49 -78 -51 -61 -42 -57 -6 -13 -7 -67 -93 -62 -55 -85 -17 -68 0
0 -91 -84 -59 -43 -76 -75 -65 -77 -67 -26 -65 -90 -96 -95 -64 -68 -70 -11 0
0 -57 -42 -21 -65 -56 -78 -93 -69 -11 -6 -27 -55 -76 -14 -14 -88 -56 -20 0
0 -21 -22 -27 -16 -15 -19 -67 -53 -59 -3 -16 -91 -48 -46 -75 -48 -12 -14 0
0 -88 -99 -38 -33 -33 -40 -67 -20 0 -24 -97 -10 -78 -59 -8 -35 -12 -61 0
0 -36 -75 -31 -21 -31 -18 -65 -98 -17 -54 -73 -64 -50 -38 -82 -29 -18 -5 0
0 -99 -62 -1 -19 -41 -83 -36 -89 -77 -87 -97 -13 -87 -35 -22 -44 -70 -46 0
0 -55 -29 -41 -94 -35 -91 -41 -66 -29 -6 -74 -17 -46 -3 -81 -45 -31 -13 0
0 -76 -72 -46 -93 -11 -77 -78 -88 -48 -35 -29 -73 -80 -10 -91 -28 -52 -9 0
0 -74 -89 -41 -10 -91 -76 -35 -64 -97 -17 -12 -95 -44 -53 -77 -33 -45 -63 0
0 -75 -61 -13 -24 -77 -9 -45 -63 -93 -47 -25 -91 -47 -64 -6 -33 -99 -29 0
0 -7 -15 -18 -90 -42 -16 -47 -85 -11 -33 -41 -6 -60 -81 -98 -84 -87 -65 0
0 -65 -33 -71 -80 -63 -27 -29 -49 -60 -13 -94 -76 -49 -79 -86 -59 -44 -50 0
0 -38 -97 -42 -13 -43 -39 -99 -5 -13 -71 -91 -31 -72 -31 -86 -70 -3 -18 0
0 -70 -48 -85 -12 -56 -77 -14 -58 -80 -5 -88 -62 -21 -91 -5 -54 -21 -29 0
0 0 -15 -48 -83 -39 -49 -58 -23 -65 -27 -27 -39 -81 -43 -20 -78 -93 -13 0
0 -12 -66 -41 -3 -85 -3 -92 -46 -49 -60 -60 -41 -14 -19 -11 -58 -74 -61 0
0 -43 -93 -67 -94 -78 -99 -7 -40 -35 -20 -91 -91 -59 -28 -33 -60 -45 -99 0
0 0 0 0 0 0 0 0 0 0 0 0 0 0 0  0 0 0 0